011111111110
011111111110
011111111110
011111111110
022222222220
000000000000
300000000030