000000000000
000000000000
022222222220
022222222220
022111111220
021111111120
022111111220
022222222220
022222222220
000000000000
000300000300
300000000003