000000000000
000000000000
000222222000
002222222200
022222222220
222222222222
022222222220
002222222200
000222222000
000000000000
000000300000
000000000000
000300000300
000000000000
300000000003