000000000000
000000000000
022222222220
000000000000
300000000030