000000000000
000000000000
000444444000
004422224400
044222222440
442222222244
044222222440
004422224400
000444444000
000000000000
000000300000
000000000000
000300000300
000000000000
300000000003