0000000000
0111111110
0122222210
0111111110
0000000000