000000000000
000110011000
001441144100
014444444410
144224422441
142222222241
144222222441
014422224410
001442244100
500144441005
000014410000
005001100500
000000000000
000050050000
000000000000
300000000003