0000000000
0133333310
0122222210
0133333310
0000000000